5 10
|--------|
|......-.|
|..-|.CP.|
|.F....-.|
|--------|
