5 10
|--------|
|......-.|
|..-|.C..|
|.F....-.|
|--------|
