5 10
|--------|
|...|..-.|
|..-|.c..|
|......-.|
|--------|

